111111111
100C00001
1P00000E1
100C00V01
111111111
