111111111
10E001C01
10P000001
100000Z01
10C010001
111111111
